414141414141414141414141414151
511151111115111151111111411111
141111141411114111115111411151
511151111115111154111141511111
114114115111114111115111111151
511111111111111111111115111111
111415141115114141415111111151
511111111111111511111111111111
111154141414141111115115111151
511111151151111111111111111111
114151111111151111114141114151
511111141151111111111151111111
111111111111111111111111114151
511141111141141111111411111111
111111111111115154111111511151
511411414141151111111111111111
111111511115111114115111141151
511511111111111111511111111111
111111111115111111111111111151
511511111411111111411151111111
111111111115111111111111111151
511541411411111111111141111111
111111111111115111411111111151
511115111111111111111111111111
111111114111151111111111111151
511115115111111111111111111111
111111111111511114111111111151
511114141411111111111151111111
111111111111111111111111111151
114141414141414141414141414141
114141414141414141414141414141