1111111111111111111111111111111111111111
1000000000000000000000000000000000000011
1000000000101000000000000000000000000011
1000000000101000000000000000000000000011
1111111111101111111111111111111111111111
1000000000000000000000000000000000000011
1000000000000000101000000000000000000011
1000000000000000101000000000000000000011
1111111111111111101111111111111111111111
1000000000000000000000000000000000000011
1000001010000000000000000000100010000011
1000001010000000000000000000100010000011
1111111011111111111111111111100011111111
1000000000000000000000000000000000000011
1000000010001000000000000000000000000011
1000000010001000000000000000000000000011
1111111110001111111111111111111111111111
1000000000000000000000000000000000000011
1000000000000000000000000000000000000011
1000000000000000000000000000000000000011
1000000000000000000000000000000000000011
1000000000000000000000000000000000000011
1000000000000000000000000000000000000011
1000000000000000000000000000000000000011
1000000000000000000000000000000000000011
1000000000100010000000000000000000000011
1000000000100010000000000000000000000011
1111111111100011111111111111111111111111
1111111111100011111111111111111111111111
1111111111100011111111111111111111111111
1111111111100011111111111111111111111111
1111111111100011111111111111111111111111
1000000000000000000000000000000000000011
1000000000000000000000000000000000000011
1000000000000000000000000000000000000011
1000000000000000000000000000000000000011
1000000000000000000000000000000000000011
1000000000000000000000000000000000000011
1000000000000000000000000000000000000011
1111111111111111111111111111111111111111
1111111111111111111111111111111111111111