1111111111111111111111111111111111111111
1000000000000000000000000000000000000001
1000000000000000000000000000000000000001
1000001000000000000000000000000000000001
1100001000000000000000000000000000000001
1100001000000000000000000000000000000001
1100000000000000000000000000000000000001
1100000000000000000000000000000000000001
1000001111011100100100000000000000000001
1000000010010010111100000000000000000001
1000001010010010100100000000000000000001
1000000100011100100100011110000000000001
1000000000000000000000011110000000000001
1000000000000000000000011110000000000001
1000000000000010000000000000000000000001
1000000000000001000000000000000000000001
1000000000000000000000000000000000000001
1000000000000000000000000000000000000001
1000000000000000000000000000000000000001
1000000000000000000000000000000000000001
1000000000000000000000000000000000000001
1000000000000000000000000000000000000001
1000000000000001111001111001111000000001
1000000000000001111001111001111000000001
1000000000000001111001111001111000000001
1000000000000000000000000000000000000001
1000000000000000000000000000000000000001
1000000000000000000000000000000000000001
1000000000000000000000000000000000000001
1000000000000000000000000000000000000001
1000000000000000000000000000000000000001
1000000000000000000000000000000000000001
1000000000000000000000000000000000000001
1000000000000000000000000000000000000001
1000000000000000000000000000000000000001
1000000000000000000000000000000000000001
1000000000000000000011110000000000000001
1000000000000000000011110000000000000001
1000000000000000000011110000000000000001
1000000000000000000000000000000000000001
1111111111111111111111111111111111111111