111111111111111111111111111111
100010000001000010000000110011
111010011111001110001000110011
100010000001000011100111100011
101111101000001110001000000011
100000001000000000001001000011
100111011001001111111001000011
100001000001000100001000000011
100011111111111000001001000011
100010010010000000001001000011
101110010010010000001111001111
100010011010010000000010000011
100000000010000000000010001111
100011000011011000000110000011
100000000000001011100000100011
100110111111011010000000000011
100000100001010001101000011011
100100000001000000101000000011
100000000001000000100000000011
100100000111000000110010000011
100100000001000000000010000011
100111110111000000000011000011
100100000000001000110000000011
100001000000001000000000000011
100000001100010000000000000011
100001001000010000000000000011
100001001000100001100000000011
100001111110000000000010000011
100000000000000000000010000011
111111111111111111111111111111
111111111111111111111111111111