6777777777777777777777777777777777777781
d000000000000000000000000000000000000099
d000000000806000000000000000000000000099
cbbbbbbbbba0cbbbbbbbbbbbbbbbbbbbbbbbbbaa
effffffffff0ffffffffffffffffffffffffffgg
d000000000000000000000000000000000000099
d000000000000000806000000000000000000099
cbbbbbbbbbbbbbbba0cbbbbbbbbbbbbbbbbbbbaa
effffffffffffffff0ffffffffffffffffffffgg
d000000000000000000000000000000000000099
d000008060000000000000000000800060000099
cbbbbba0cbbbbbbbbbbbbbbbbbbba000cbbbbbaa
effffff0fffffffffffffffffffff000ffffffgg
d000000000000000000000000000000000000099
d000000080006000000000000000000000000099
cbbbbbbba000cbbbbbbbbbbbbbbbbbbbbbbbbbaa
effffffff000ffffffffffffffffffffffffffgg
d000000000000000000000000000000000000099
d000000000000000000000000000000000000099
d000000000000000000000000000000000000099
d000000000000000000000000000000000000099
d000000000000000000000000000000000000099
d000000000000000000000000000000000000099
d000000000000000000000000000000000000099
d000000000000000000000000000000000000099
d000000000800060000000000000000000000099
cbbbbbbbbba000cbbbbbbbbbbbbbbbbbbbbbbbaa
effffffffff000ffffffffffffffffffffffffgg
cbbbbbbbbba000cbbbbbbbbbbbbbbbbbbbbbbbaa
effffffffff000ffffffffffffffffffffffffgg
cbbbbbbbbba000cbbbbbbbbbbbbbbbbbbbbbbbaa
effffffffff000ffffffffffffffffffffffffgg
d000000000000000000000000000000000000099
d000000000000000000000000000000000000099
d000000000000000000000000000000000000099
d000000000000000000000000000000000000099
d000000000000000000000000000000000000099
d000000000000000000000000000000000000099
d000000000000000000000000000000000000099
cbbbbbbbbbbbbbbbbbbbbbbbbbbbbbbbbbbbbbaa
cbbbbbbbbbbbbbbbbbbbbbbbbbbbbbbbbbbbbbaa